32
16
00000000000000000000000000000000
00000000000000000000000000000000
11111111111100000000000000000000
00000000000100000000000000000000
00000000000100000000000000000000
00000000000100000001111111111111
00000011111100000001000000000000
00000010000000000001000000000000
00000010000000000001000000000000
00000010000000000001000000000000
00000011111111100001000000000000
00000000000000100001000000000000
00000000000000111111000000000000
00000000000000000000000000000000
00000000000000000000000000000000
00000000000000000000000000000000